############
#          #
# *      o #
#   ####   #
#   ####   #
#   ####   #
# o      o #
#          #
############
